acceptance = приём, признание, принятие, одобрение = 1
advanced = передовой, прогрессивный = 1
advertisement = рекламный, реклама, объявление, анонс = 1
at least = по крайней мере, хотя бы = 1
bidding = торги, предложение цены = 1
binding = связь, связывающий, сращивание = 1
boundary = граница, пограничный, черта = 1
cannot = не могу = 1
certain = определённый, точный, некоторый = 1
confluence = слияние, пересечение, толпа = 1
convert = переделать, переделывать, преобразовать, преобразовывать, реконструировать = 1
crawl = сканировать, ползать = 1
currently = в настоящее время, сейчас, настоящий, текущий = 1
decision = решение, выбор = 1
dictionary = словарь = 1
different = различный, другой = 1
doing = делающий = 1
during = втечение = 1
engine = мотор, двигатель, механизм = 1
entity = сущность, объект = 1
entry = начальный, входной, вход, въезд = 1
example = пример, образец, экземпляр = 1
exhibit = экспонат, выставка, показывать, выставлять = 1
experience = опыт, стаж = 1
explosion = взрыв, взрывной = 1
fallacy = ошибка, заблуждение = 1
flexible = гибкий = 1
from scratch = с нуля = 1
habit = привычка, традиция, обычай, особенность = 1
have = иметь, обладать, получать = 1
hire = нанимать, наём = 1
inconsistent = несовместимый, несоответствующий = 1
indentation = углубление, вырез, отпечаток, отступ = 1
instant = 	момент, мгновенный, мгновение, текущий, немедленный = 1
interior = интерьер, внутренняя поверхность = 1
intermediate = средний, промежуточный = 1
into = в, к, на = 1
invite = приглашать, призывать = 1
involving = с участием, включающий, предусматривающий = 1
issue = вопрос, проблема = 1
large = большой, крупный, значительный = 1
lead = вести, руководить, управлять, командовать = 1
listen = слушать, выслушивание = 1
looking = ищущий, глядящий, следящий = 1
look = смотреть, искать = 1
mine = добывать, рудник, шахта = 1
mining = добыча = 1
мust have = должно быть = 1
need = нужно, необходимо = 1
one time = один раз = 1
ongoing = постоянный = 1
opportunity = возможность, перспектива = 1
pipe = труба = 1
prediction = прогноз, предсказание, пророчество = 1
produce = продукт, продукция, изделие, производить, изготавливать = 1
proposal = заявка, предложение = 1
quote = цитата, выдержка = 1
rating = ранг, разряд, оценка = 1
recency = новизна, свежесть = 1
related = связанный = 1
relative = относительный, условный, взаимный, родственник = 1
relevance = уместность, актуальность, значимость, важность = 1
render = исполнять, передавать, оказывать = 1
require = нуждаться, требовать, обязательный = 1
research = исследование, изучение, изыскание = 1
respective = соответствующий, соответственный, соответственно = 1
response = ответ, отклик = 1
reusable = многоразовый, повторно используемый = 1
scraping = выскабливание = 1
scrap = вырезка = 1
self = сам, себя, само, собственная личность = 1
several = несколько, некоторый = 1
sharp = чёткий, острый, определённый = 1
shortcut = ярлык = 1
since = после, впоследствии, после того, так как = 1
signup = регистрация = 1
someone = кто-то, некто = 1
spending = затраты, расходы = 1
spoken = разговорный, устный = 1
spreadsheet = таблица = 1
statement = отчет, изложение, заявление = 1
stats = статистика = 1
supplier = поставщик = 1
tail = хвост, конец, задний, хвостовой = 1
task = задача = 1
term = условие, срок, период = 1
those = те, то = 1
title = заголовок, заглавие, название, надпись = 1
town = город = 1
turn = обращать, оборот, поворот, изменить направление = 1
understanding = понимание, осмысление, соглашение = 1
vehicle = автомобиль = 1
watch = смотреть, наблюдать, следить, караулись, вахта, дозор = 1
wet = мокрый, сырой, жидкий, мочить, влажность, сырость = 1
when = когда, как только, если, хотя, который = 1
while = пока, хотя, не смотря на = 1
within = не позднее, втечение, внутри, в пределах = 1
with = с, от, за, у, со, причём = 1
