AA = всё после...
AB = всё до...
ABT = около
ABV = повторяю в виде аббревиатур
AС = переменный ток
ADR = адрес
ADDR = адрес
ADS = адрес
AFTER = после
AGN = снова
ALSO = также, тоже
AM = амплитудная модуляция; по полуночи
AMP, AMPS = ампер, амперы
ANS = ответ
ANT = антенна
AR = конец передачи
AS = жду, ждите
AT TIMES = временами
AUD = слышимость
AWDH = auf wiederhoeren - услышимся (немецкий)
BAD = плохо, плохой
BD = плохо, плохой
BAND = диапазон
BCI = помехи радиовещанию
BCL = радиослушатель
BCNU = встретимся снова
BEAM = направленная антенна
BEST = лучший
BFR = до, перед
B4 = до, перед
BJR = bonjour - здравствуйте (французский)
BK = передавайте в паузах моей передачи; работаю полудуплексом
BN = между
BOX = ящик
BТ = =, знак раздела
BTR = лучше
BUG = виброплекс
BUT = но
BURO = QSL-бюро, служба рассылки QSL-карточек
BY = посредством, при помощи
C = да (итальянский)
CALL = вызов, позывной
CAN = могу
CANT = не могу
CARD = карточка-квитанция
CB = гражданский диапазон 27 МГц
CC = кварцевая стабилизация
CFM = подтвердите, подтверждаю
CHEERIO = желаю успеха
CITY = город
CK = проверка
CKT = схема
CL = прекращаю работу
CLD = вызывал, вызывать
CLG = вызывал, вызывать
CLEAR = ясно (про погоду)
CLOUDY = облачно (про погоду)
CO = кварцевый генератор
COLD = холодно
CONDX = условия
CONGRATS = поздравления
COPI = принять, записать
CP = противовес
CPY = принять, записать
CQ = общий вызов
CU = встретимся в эфире
CUAGN = встретимся снова
CUL = встретимся позже
CW = телеграф, работать телеграфом
DC = постоянный ток
DE = от (такого-то), вас вызывает такой-то
DIRECT = напрямую, непосредственно
DLVD = передано
DN = вниз, ниже
DOPE = приятное сообщение
DR = дорогой
DWN = вниз, ниже
DX = дальний корреспондент
EAST = восток
EL BUG = электронный полуавтоматический ключ
END = конец
ES = и
EU = Европа
ENUF = достаточно
EME = радиосвязь через Луну
ETA = ожидаемое время прибытия
EVE = вечер
EVY = каждый
EX = бывший (про позывной)
FAIR = превосходно, прекрасно (о погоде)
FB = отлично, прекрасно
FD = удвоитель частоты
FINE = хороший, отличный
FIRST = первый
FM = из, от
FRM = из, от
FROM = из, от
FONE = радиотелефон, работать телефоном
FR = для, за
FER = для, за
FOR = для, за
FREQ = частота
FROST = мороз
FB = отлично, прекрасно
GA = добрый день (после обеда)
GB = до свидания
GD = добрый день
GE = добрый вечер
GEN = генератор
GET = получать
GL = желаю удачи
GLD = рад
GM = доброе утро
GMТ = всемирное время по Гринвичу
GN = доброй ночи
GND = заземление, грунт
GOT = получил
GUD = хорошо
GUHOR = вас не слышу
HAM = радиолюбитель, имеющий передатчик
HEAR = слышать
HF = высокая частота
HI = выражение смеха
HNY = с Новым годом
HOPE = надеюсь
HPE = надеюсь
HOT = жарко
HR = здесь, слышать
HRS = часы
HT = высокое напряжение
HV = иметь
HVI = тяжёлый, сильные
HVY = тяжелый, сильный (например, о помехах)
HW? = как поняли?
HZ = герц
IN = в
INFO = информация
HV = иметь
INPUT = подводимая мощность
INPT = подводимая мощность
IS = есть
K = передавайте, перехожу на прием
KА = начало передачи
KHZ = килогерц
KN = перехожу на прием, слушаю только своего корреспондента
KN = знать, знаю
KNOW = знать, знаю
KW = знать, знаю
LAST = последний
LAT = широта
LF = низкая частота
LID = неумелый оператор
LOCAL = местный
LOG = список радиостанций
LONG = долгота; длинный; долго
LP = длинный путь распространения радиоволны
LPM = букв в минуту
LSB = нижняя боковая полоса
LUCK = успех; счастье
MA = миллиампер
MEET = встретить
MF = микрофарада
MGR = QSL-менеджер, уполномоченный по рассылке QSL-карточек
MHZ = мегагерц
MIKE = микрофон
MILE = миля
MILS = миллиамперы
MISD = пропустил
MN = минуты
MNI = много
MO = задающий генератор
MOD = модуляция
MSG = сообщение
MSK = московское время
MTR = метр
N = нет
NEAR = близ; возле, около
NET = сеть
NEW = новый
NICE = приятный, хороший
NIL = ничего не имею вам сообщить
NO = нет
NORTH = север
NOT = не
NR = номер; возле, около
NW = сейчас
OB = приятель, старина
OC = приятель
OK = OK - понял, принял правильно
OLD = понял, принял правильно
OM = приятель, старина
ON = на
ONLY = только
OP = оператор
OPR = оператор
OSC = генератор
OUTPT = отдаваемая мощность
PA = усилитель мощности
PART = часть
PM = поплудни 
PR = пакетная радиосвязь 
PSE = пожалуйста
PSED = доволен, рад
PWR = мощность
QLF = работать на ключе левой ногой (шутка, в официальный Q-код не входит)
R = всё понял
RAC = грубый тон переменного тока
RAIN = дождь
RCD = принято
RCVD = принято
RCVR = приёмник
RDN = излучение
RDO = радио
REF = ссылка (на книгу)
RFI = радиопомехи
RIG = оборудование радиостанции, передатчик, трансивер
RPRT = рапорт
RPT = повторите, повторяю
RQ = запрос
RST = оценка разборчивости, громкости и качества сигнала
RSM = оценка разборчивости, громкости и качества сигнала
RS = оценка разборчивости, громкости и качества сигнала
RTTY = радиотелетайп
RX = приёмник
SA = скажите
SAE = конверт с обратным адресом
SASE = конверт с обратным адресом и марками
SECOND = второй
SED = сказал
SEND = посылать, передавать
SIG = подпись; сигнал
SK = конец связи
SKED = расписание работы
SM = некоторые, несколько
SN = скоро
SNOW = снег
SOLID = уверенно, солидно
SOON = скоро
SP = короткий путь распространения радиоволны
SPK = говорить
SRI = извините
SSB = однополосный сигнал
STDI = устойчиво
STN = станция
STRONG = сильно
SURE = уверенность, будьте уверены
SVC = служба, служебный
SW = короткие волны
SWL = коротковолновик-наблюдатель
SWR = коеффициент стоячей волны
TEN = "десятка" - десятиметровый диапазон
TEST = соревнование
TFC = трафик, обмен
TFX = трафик, обмен
TIA = заранее благодарен
TILL = до
TIME = время
TMR = завтра
TMW = завтра
TNX = спасибо
TKS = спасибо
TKU = спасибо
TU = спасибо
TO = к, для
TODI = сегодня
TONE = тон
TOO = слишком
TX = передатчик
TMTR = передатчик
XMTR = передатчик
TRBL = затруднения
TRUB = затруднения
TRCVR = трансивер
TRX = трансивер
XCVR = трансивер
TUBE = радиолампа
TVI = помехи телевидению
TXT = текст
U = вы
UFB = превосходно
UNLIS = владелец нелегального передатчика, радиохулиган
UNSTDI = нестабильно, неустойчиво
UP = верх, выше
UR = ваш, ваши
URS = ваш, ваши
USB = верхняя боковая полоса
UT = универсальное время
UTC = универсальное время
VALVE = радиолампа
VERT = вертикальный
VCO = генератор, управляемый напряжением
VFO = генератор плавного диапазона
VHF = сверхвысокие частоты
VIA = через, посредством (QSL VIA RA3AAA)
VXO = перестраиваемый кварцевый генератор
VY = очень
W = слово
WARM = тепло
WAVE = волна
WD = слово
WDS = слова
WEAK = слабый
WELL = хорошо
WEST = запад
WID = с
WIND = ветер
WKD = работал (с таким-то)
WL = будет, буду
WLL = будет, буду
WPM = слов в минуту
WRD = слово
WRK = работа, работать
WRKD = работал
WRKED = работал
WTTS = ватты
WW = всемирный, весь мир
WX = погода
XTAL = кварцевый резонатор
XMAS = рождество
XUSE = извините
XYL = жена
YDAY = вчера
YL = девушка
73 = наилучшие пожелания
88 = любовь и поцелуй
99 = не желаю с вами работать
БЛГ = благодарю
ДСВ = до свидания
ЗДР = здравствуйте
СПБ = спасибо

